{
	"size": {"w": 8, "h": 9},
	"map": [
		[0, 0, 0, 0, 0, 0, 8, 8],
		[0, 0, 4, 3, 2, 0, 8, 4],
		[6, 8, 8, 8, 8, 8, 8, 0],
		[0, 8, 0, 8, 0, 8, 8, 0],
		[0, 1, 8, 8, 8, 8, 0, 0],
		[0, 0, 8, 0, 8, 8, 8, 8],
		[0, 8, 8, 0, 8, 8, 8, 5],
		[0, 0, 8, 0, 8, 0, 0, 0],
		[0, 0, 2, 7, 8, 0, 0, 0]
	]
}
