{
	"size": {"w": 8, "h": 5},
	"map": [
		[1, 8, 8, 8, 8, 8, 8, 2],
		[8, 8, 0, 0, 0, 0, 8, 8],
		[8, 8, 7, 0, 0, 5, 8, 8],
		[8, 8, 0, 0, 0, 0, 8, 8],
		[3, 8, 8, 8, 8, 8, 8, 4]
	]
}
